Sommar­champinjon - Agaricus altipes
Strandängs­champinjon - Agaricus bernardii
Spetsfotad champinjon - Agaricus litoralis
Blekröd dvärg­champinjon - Agaricus semotus
Skogs­champinjon - Agaricus sylvaticus
Vit kungs­champinjon - Agaricus urinascens
Gul åkerskivling - Agrocybe pediades
Tidig åkerskivling - Agrocybe praecox
Ängsticka - Albatrellus syringae
Zonkamskivling - Amanita battarrae
Jättekamskivling - Amanita ceciliae
Gråfotad flugsvamp - Amanita excelsa
Gulbrämad flugsvamp - Amanita franchetii
Brun kamskivling - Amanita fulva
Gul flugsvamp - Amanita gemmata
Bleknande kamskivling - Amanita lividopallescens
Mörkringad flugsvamp - Amanita porphyria
Rodnande flugsvamp - Amanita rubescens
Gråstrumpig kamskivling - Amanita submembranacea
Grå kamskivling/vit kamskivling - Amanita vaginata
Vanlig honungsskivling - Armillaria borealis
Honungskivlingar - Armillaria mellea s.lat.
Liten kandelabersvamp - Artomyces cristatus
Kandelabersvamp - Artomyces pyxidatus
Stoftkremling - Asterophora lycoperdoides
Svartöra - Auricularia mesenterica
Örtaggsvamp - Auriscalpium vulgare
Talltaggsvamp - Bankera fuligineoalba
Grantaggsvamp - Bankera violascens
Svedticka - Bjerkandera adusta
Guldskivling - Bolbitius titubans
Tallgråticka - Boletopsis grisea
Grangråticka - Boletopsis leucomelaena
Limsvamp - Bulgaria inquinans
Bronssopp - Butyriboletus appendiculatus
Sommarsopp - Butyriboletus fechtneri
Bittersopp - Caloboletus calopus
Rotsopp - Caloboletus radicans
Gullpigg - Calocera cornea
Gullhorn - Calocera viscosa
Ametistkantarell - Cantharellus amethysteus
Cantharellus cibarius - Orange kantarell
Orange kantarell - Cantharellus friesii
Cantharellus friesii - Blek kantarell
Pepparsopp - Chalciporus piperatus
Rodnande fjällskivling - Chlorophyllum rachodes
Rabarbersvamp - Chroogomphus rutilus
Gullnavling - Chrysomphalina chrysophylla
Hängeskål - Ciboria caucus
Violett fingersvamp - Clavaria zollingeri
Stor klubbsvamp - Clavariadelphus pistillaris
Trådticka - Climacocystis borealis
Vit tuvskivling - Clitocybe connata
Pudrad trattskivling - Clitocybe nebularis
Liten vårtrattskivling - Clitocybe pruinosa
Gifttrattskivling - Clitocybe rivulosa
Svedjetrattskivling - Clitocybe sinopica
Skinnticka - Coltricia perennis
Klockhätting - Conocybe albipes
Glitterbläcksvamp - Coprinellus micaceus
Puckelbläcksvamp - Coprinopsis acuminata
Grå bläcksvamp - Coprinopsis atramentaria
Snövit bläcksvamp - Coprinopsis nivea
Rutbläcksvamp - Coprinopsis picacea
Rödbandad spindling - Cortinarius armillatus
Cinnoberspindling - Cortinarius cinnabarinus
Cortinarius cinnabarinus - Gulbandad spindling
Ullspindling - Cortinarius laniger
Lökspindling - Cortinarius multiformis
Cortinarius multiformis - Orangebrun giftspindling
Cortinarius orellanus - Toppig giftspindling
Rödskivig kanelspindling - Cortinarius semisanguineus
Bockspindling - Cortinarius traganus
Olivspindling - Cortinarius venetus
Grå kantarell - Craterellus cinereus
Craterellus lutescens - Svartnande kantarell
Svartnande kantarell - Craterellus melanoxeros
Kruskantarell - Craterellus sinuosus
Stråbrosking - Crinipellis scabella
Gul brödkorgssvamp - Crucibulum laeve
Musseron­vaxskivling - Cuphophyllus fornicatus
Grålila vaxskivling - Cuphophyllus lacmus
Läder­vaxskivling - Cuphophyllus russocoriaceus
Vit vaxskivling - Cuphophyllus virgineus
Blygrå brödkorgssvamp - Cyathus olla
Strimmig brödkorgssvamp - Cyathus striatus
Flockig puderskivling - Cystolepiota adulterina
Violettfotad puderskivling - Cystolepiota bucknallii
Kork­mussling - Daedalea quercina
Gråbrun sammets­musseron - Dermoloma cuneifolium
Sippskål - Dumontinia tuberosa
Majrödling - Entoloma aprile
Blårödling - Entoloma bloxamii
Entoloma bloxamii - Rosabrun nopping
Rosabrun nopping - Entoloma catalaunicum
Stornopping - Entoloma griseocyaneum
Mjölrödskivling - Entoloma prunuloides
Lundnopping - Entoloma queletii
Bleknopping - Entoloma sericellum
Oxtungssvamp - Fistulina hepatica
Gul flamskivling - Flammula alnicola
Fnöskticka - Fomes fomentarius
Klibbticka - Fomitopsis pinicola
Rosenticka - Fomitopsis rosea
Gifthätting - Galerina marginata
Platticka - Ganoderma lipsiense
Lackticka - Ganoderma lucidum
Grå vaxskivling - Gliophorus irrigatus
Brosk­vaxskivling - Gliophorus laetus
Papegoj­vaxskivling - Gliophorus psittacinus
Korallticka - Grifola frondosa
Ringbitterskivling - Gymnopilus spectabilis
Blek nagelskivling - Gymnopus dryophilus
Stinkbrosking - Gymnopus foetidus
Räfflad nagelskivling - Gymnopus fusipes
Kanelnagelskivling - Gymnopus putillus
Alsopp - Gyrodon lividus
Blek stenmurkla - Gyromitra gigas
Biskopsmössa - Gyromitra infula
Kastanjesopp - Gyroporus castaneus
Doftticka - Haploporus odorus
Kakaofränskivling - Hebeloma laterinum
Senapsfränskivling - Hebeloma sinapizans
Pokalmurkla - Helvella acetabulum
Blek pokalmurkla - Helvella costifera
Sotmurkla - Helvella nigricans
Bleksopp - Hemileccinum impolitum
Poppeltofsskivling - Hemipholiota populnea
Tårkragskivling - Hemistropharia albocrenulata
Gyttrad taggsvamp - Hericium cirrhatum
Koralltaggsvamp - Hericium coralloides
Luddskål - Humaria hemisphaerica
Orange taggsvamp - Hydnellum aurantiacum
Brandtaggsvamp - Hydnellum auratile
Blå taggsvamp - Hydnellum caeruleum
Ruttaggsvamp - Hydnellum illudens
Vit taggsvamp - Hydnum albidum
Kantarell­vaxskivling - Hygrocybe cantharellus
Spröd vaxskivling - Hygrocybe ceracea
Gul vaxskivling - Hygrocybe chlorophana
Gröngul vaxskivling - Hygrocybe citrinovirens
Blod­vaxskivling - Hygrocybe coccinea
Hygrophoropsis aurantiaca - Hygrophoropsis rufa
Gulprickig vaxskivling - Hygrophorus chrysodon
Ek­vaxskivling - Hygrophorus cossus
Disk­vaxskivling - Hygrophorus discoideus
Slemringad vaxskivling - Hygrophorus gliocyclus
Vitgrå vaxskivling - Hygrophorus korhonenii
Tall­vaxskivling - Hygrophorus latitabundus
Ekgrädd­vaxskivling - Hygrophorus penarioides
Vitbrun vaxskivling - Hygrophorus persoonii
Kremle­vaxskivling - Hygrophorus russula
Tegelröd slöjskivling - Hypholoma lateritium
Gul svampsnylting - Hypomyces chrysospermus
Blodriskssnylting - Hypomyces lateritius
Almskivling - Hypsizygus ulmarius
Brunsopp - Imleria badia
Småfjällig trattskivling - Infundibulicybe squamulosa
Stjärntråding - Inocybe asterospora
Mosstråding - Inocybe nitidiuscula
Tårticka - Inonotus dryadeus
Kärnticka - Inonotus dryophilus
Sprängticka - Inonotus obliquus
Ametistskivling - Laccaria amethystina
Gaffel­riska - Lactarius acerrimus
Brand­riska - Lactarius aurantiacus
Blek rök­riska - Lactarius azonites
Grön­riska - Lactarius blennius
Avenboks­riska - Lactarius circellatus
Bukt­riska - Lactarius flexuosus
Räv­riska - Lactarius fulvissimus
Kokos­riska - Lactarius glyciosmus
Gulskivig riska - Lactarius hysginus
Mörk kokos­riska - Lactarius mammosus
Tall­riska - Lactarius musteus
Blek­riska - Lactarius pallidus
Slät vit­riska - Lactarius piperatus
Hassel­riska - Lactarius pyrogalus
Ek­riska - Lactarius quietus
Stink­riska - Lactarius serifluus
Stink­riska - Lactarius serifluus
Lila­riska - Lactarius uvidus
Luden vit­riska - Lactarius vellereus
Grå­riska - Lactarius vietus
Stor lila­riska - Lactarius violascens
Gran­riska - Lactarius zonarioides
Svavelticka - Laetiporus sulphureus
Gul strävsopp - Leccinellum crocipodium
Aspsopp - Leccinum aurantiacum s.lat.
Brun aspsopp - Leccinum duriusculum
Eksopp - Leccinum quercinum
Vit ved­fingersvamp - Lentaria epichnoa
Rynk­mussling - Lentinellus vulpinus
Doft­mussling - Lentinus suavissimus
Slemmurkling - Leotia lubrica
Gulflockig fjällskivling - Lepiota magnispora
Iris­musseron - Lepista irina
Ängs­musseron - Lepista luscina
Höst­musseron - Lepista saeva
Viol­musseron - Lepista sordida
Viol­musseron - Lepista sordida
­champinjonfjällskivling - Leucoagaricus leucothites var. leucothites
Jättetrattskivling - Leucopaxillus giganteus
Rosentrattskivling - Leucopaxillus rhodoleucus
Ängs­röksvamp - Lycoperdon pratense
Gyttrad röksvamp - Lycoperdon pyriforme
Skål­röksvamp - Lycoperdon utriforme
Mörk tuvskivling - Lyophyllum decastes
Transkräling - Macrocystidia cucumis
Fnasig fjällskivling - Macrolepiota excoriata
Puckel­fjällskivling - Macrolepiota mastoidea
Puckel­fjällskivling - Macrolepiota mastoidea
Grenbrosking - Marasmiellus ramealis
Veckbrosking - Marasmius siccus
Sommar­musseron - Melanoleuca strictipes
Granatskivling - Melanophyllum haematospermum
Sommarhätta - Mycena abramsii
Orangehätta - Mycena acicula
Gräshätta - Mycena aetites
Fjunhätta - Mycena amicta
Guldeggad hätta - Mycena aurantiomarginata
Rödeggad klorhätta - Mycena capillaripes
Boklövshätta - Mycena capillaris
Dynhätta - Mycena chlorantha
Mjölhätta - Mycena cinerella
Mjölhätta - Mycena cineroides
Gulhätta - Mycena citrinomarginata
Tallhätta - Mycena clavicularis
Mycena clavicularis - Mycena concolor
Saffranshätta - Mycena crocata
Blåtrådshätta - Mycena cyanorhiza
Flåhätta - Mycena epipterygia
Bokhätta - Mycena fagetorum
Jodhätta - Mycena filopes
Mycena filopes - Mycena flavescens
Gulvit hätta - Mycena flavoalba
Mycena flavoalba - Mycena floridula
Rynkhätta - Mycena galericulata
Mjölkhätta - Mycena galopus
Blodhätta - Mycena haematopus
Mosshätta - Mycena hiemalis
Tuvhätta - Mycena inclinata
Halhätta - Mycena laevigata
Mycena laevigata - Mycena latifolia
Klorhätta - Mycena leptocephala
Aprikoshätta - Mycena leptophylla
Mycena leptophylla - Mycena maculata
Rothätta - Mycena megaspora
Barkhätta - Mycena meliigena
Frosthätta - Mycena metata
Mycena metata - Mycena mirata
Blek rynkhätta - Mycena niveipes
Bruneggad hätta - Mycena olivaceomarginata
Fagerhätta - Mycena oregonensis
Falsk rättikhätta - Mycena pelianthina
Kottehätta - Mycena plumipes
Silverhätta - Mycena polygramma
Silverhätta - Mycena polygramma
Rättikhätta - Mycena pura
Purpurhätta - Mycena purpureofusca
Gulfotshätta - Mycena renati
Rosa rättikhätta - Mycena rosea
Rosenhätta - Mycena rosella
Rödeggad hätta - Mycena rubromarginata
Mörkeggad blodhätta - Mycena sanguinolenta
Pelargonhätta - Mycena septentrionalis
Vårluthätta - Mycena silvae-nigrae
Kvisthätta - Mycena speirea
Luthätta - Mycena stipata
Sockelhätta - Mycena stylobates
Vinterhätta - Mycena tintinabulum
Mycena tintinabulum - Mycena urania
Gröneggad hätta - Mycena viridimarginata
Stor flåhätta - Mycena viscosa
Glanshätta - Mycena vitilis
Klibbhätta - Mycena vulgaris
Fläckhätta - Mycena zephirus
Stor lökbrosking - Mycetinis alliaceus
Cinnobergömming - Nectria cinnabarina
Lut­vaxskivling - Neohygrocybe nitrata
Gyttrad nästsvamp - Nidularia deformis
Luddticka - Onnia tomentosa
Grå larvklubba - Ophiocordyceps entomorrhiza
Kantbroking - Panaeolus cinctulus
Vinter­mussling - Panellus mitis
Lila­mussling - Panellus ringens
Epålettsvamp - Panellus stipticus
Brosk­mussling - Panus conchatus
Alpluggskivling - Paxillus filamentosus
Stor rotskräling - Phaeocollybia lugubris
Grovticka - Phaeolus schweinitzii
Stinksvamp - Phallus impudicus
Sälgticka - Phellinus conchatus
Eldticka - Phellinus igniarius
Tallticka - Phellinus pini
Kuddticka - Phellinus punctatus
Aspticka - Phellinus tremulae
Svartvit taggsvamp - Phellodon connatus
Svart taggsvamp - Phellodon niger
Fjällig tofsskivling - Pholiota squarrosa
Stink­mussling - Phyllotopsis nidulans
Björkticka - Piptoporus betulinus
Ärt­röksvamp - Pisolithus arrhizus
Öron­mussling - Pleurocybella porrigens
Ring­mussling - Pleurotus dryinus
Pleurotus ostreatus - Blek ostron­mussling
Svarteggad skölding - Pluteus atromarginatus
Hjortskölding - Pluteus cervinus
Blågrå skölding - Pluteus salicinus
Dystersopp - Porphyrellus porphyrosporus
Vitspröding - Psathyrella candolleana
Trattnavling - Pseudoclitocybe cyathiformis
Gullgröppa - Pseudomerulius aureus
Brandticka - Pycnoporellus fulgens
Gul fingersvamp - Ramaria flava s.lat.
Snövit fingersvamp - Ramariopsis kunzei
Plugg­musseron - Rhodocybe gemina
Brandrussling - Rhodocybe nitellina
Slemhätta - Roridomyces rorida
Falsk djävulssopp - Rubroboletus legaliae
Rosen­musseron - Rugosomyces carneus
Russula aeruginea - Russula atroglauca
Tall­kremla - Russula cessans
Russula cessans - Russula citrinochlora
Nässel­kremla - Russula consobrina
Tratt­kremla - Russula delica
Mjölfots­kremla - Russula farinipes
Gall­kremla - Russula fellea
Russula fellea - Russula fennoscandica
Stink­kremla - Russula foetens
Marsipan­kremla - Russula grata
Gaffel­kremla - Russula heterophylla
Prakt­kremla - Russula intermedia
Fager­kremla - Russula lepida
Bok­kremla - Russula mairei
Russula mairei - Russula medullata
Honungs­kremla - Russula melliolens
Senaps­kremla - Russula ochroleuca
Grön ägg­kremla - Russula olivascens
Röd ek­kremla - Russula pseudointegra
Siena­kremla - Russula puellaris
Krusbärs­kremla - Russula queletii
Aprikos­kremla - Russula risigallina
Mångfärgad kremla - Russula romellii
Rosenfots­kremla - Russula roseipes
Blod­kremla - Russula sanguinea
Tår­kremla - Russula sardonia
Sand­kremla - Russula torulosa
Skarp siena­kremla - Russula versicolor
Vin­kremla - Russula vinosa
Russula vinosa - Russula vinososordida
Viol­kremla - Russula violacea
Russula violacea - Russula violaceoincarnata
Rut­kremla - Russula virescens
Ägg­kremla - Russula vitellina
Slät taggsvamp - Sarcodon leucopus
Koppartaggsvamp - Sarcodon lundellii
Grön­mussling - Sarcomyxa serotina
Scharlakansskål - Sarcoscypha austriaca
Scharlakansvårskål s.lat. - Sarcoscypha coccinea s.lat.
Timmergröppa - Serpula himantioides
Spadmurkling - Spathularia flavida
Vågticka - Spongiporus undosus
Prakttagging - Steccherinum robustius
Stiftsvamp (s.lat.) - Stemonitis axifera (s.lat.)
Fjällsopp - Strobilomyces strobilaceus
Grankotteskivling - Strobilurus esculentus
Tallkotteskivling - Strobilurus stephanocystis
Bitter kotteskivling - Strobilurus tenacellus
Ärggrön kragskivling - Stropharia aeruginosa
Stor kragskivling - Stropharia hornemannii
Pepparkragskivling - Stropharia pseudocyanea
Hålsopp - Suillus cavipes
Slemsopp - Suillus flavidus
Sammetsfotad pluggskivling - Tapinella atrotomentosa
Källarkantarell - Tapinella panuoides
Trattöra - Thelephora caryophyllea
Busksvamp - Thelephora palmata
Borstticka - Trametes hirsuta
Brunkrös - Tremella foliacea
Skruvbusksvamp - Tremellodendropsis tuberosa
Gelétratting - Tremiscus helvelloides
Tremiscus helvelloides - Bitter riddar­musseron
Lakrits­musseron - Tricholoma apium
Kant­musseron - Tricholoma arvernense
Tricholoma arvernense - Besk kastanje­musseron
Besk kastanje­musseron - Tricholoma batschii
Fjällig gall­musseron - Tricholoma bresadolanum
Riddar­musseron - Tricholoma equestre
Krag­musseron - Tricholoma focale
Rök­musseron - Tricholoma fucatum
Fläck­musseron - Tricholoma fulvum
Tricholoma fulvum - Blek streck­musseron
Blek streck­musseron - Tricholoma guldeniae
Fjäll­musseron - Tricholoma imbricatum
Tricholoma saponaceum var. squamosum - Gulnande musseron
Gulnande musseron - Tricholoma scalpturatum
Puckel­musseron - Tricholoma sciodes
Tricholoma sciodes - Sydlig kant­musseron
Sydlig kant­musseron - Tricholoma sejunctum s. str.
Rättik­musseron - Tricholoma stiparophyllum
Jord­musseron - Tricholoma terreum
Skägg­musseron - Tricholoma vaccinum
Gulgrön kant­musseron - Tricholoma viridilutescens
Stubb­musseron - Tricholomopsis decora
Toffelskräling - Tubaria furfuracea
Vindlad klockmurkla - Verpa bohemica
Vit slidskivling - Volvopluteus gloiocephalus
Boksopp - Xerocomellus pruinatus
Stubbhorn - Xylaria hypoxylon
